LAM MK;LU;BU;SU;TOTAAL;BT
722;31;1;0;32;MDU
1417;0;40;0;40;MDU
11983;0;2;0;2;MDU
11985;2;1;1;4;MDU
12711;0;1;0;1;SDU
12721;0;4;0;4;MDU
52537;0;3;0;3;MDU
52539;3;1;0;4;MDU
52547;0;6;0;6;MDU
52549;1;0;0;1;SDU
59266;0;2;0;2;MDU
59270;0;3;0;3;MDU
59271;1;1;0;2;MDU
59272;6;0;0;6;MDU
59273;0;1;0;1;SDU
59274;18;2;0;20;MDU
59276;0;1;0;1;SDU
59277;18;2;0;20;MDU
59279;0;1;0;1;SDU
59280;0;1;0;1;SDU
59289;0;47;0;47;MDU
59293;0;1;0;1;SDU
59295;0;1;0;1;SDU
59296;0;1;0;1;SDU
59297;0;1;0;1;SDU
59298;2;0;1;3;MDU
59299;1;1;0;2;MDU
59300;9;0;0;9;MDU
59302;3;0;0;3;MDU
62059;2;0;0;2;MDU
62060;3;2;0;5;MDU
62065;0;1;0;1;SDU
62428;6;0;0;6;MDU
62430;9;0;1;10;MDU
62432;6;0;0;6;MDU
62433;0;1;0;1;SDU
62434;0;3;1;4;MDU
62435;0;2;0;2;MDU
62437;18;3;0;21;MDU
62438;0;1;0;1;SDU
62439;1;4;0;5;MDU
62440;0;1;0;1;SDU
62441;0;1;0;1;SDU
62442;3;0;0;3;MDU
62443;0;7;0;7;MDU
62444;0;1;0;1;SDU
62445;0;1;0;1;SDU
62446;0;1;0;1;SDU
108063;3;1;0;4;MDU
108064;3;1;0;4;MDU
108065;8;1;0;9;MDU
108067;4;2;0;6;MDU
108068;0;1;0;1;SDU
108069;3;1;0;4;MDU
108073;35;1;0;36;MDU
108074;23;3;0;26;MDU
108075;0;1;0;1;SDU
108076;79;2;0;81;MDU
108077;2;0;0;2;MDU
108078;11;0;0;11;MDU
108079;4;1;0;5;MDU
108080;0;1;0;1;SDU
108081;12;0;0;12;MDU
108082;6;0;1;7;MDU
108083;0;1;0;1;SDU
108085;3;0;0;3;MDU
108271;1;0;0;1;SDU
108272;8;0;0;8;MDU
108274;0;1;0;1;SDU
108275;4;0;0;4;MDU
108278;0;1;0;1;SDU
108281;0;2;0;2;MDU
108283;0;1;1;2;SDU
108284;3;2;0;5;MDU
108285;0;1;0;1;SDU
108287;3;1;0;4;MDU
108288;4;0;1;5;MDU
108289;4;1;0;5;MDU
108290;4;1;0;5;MDU
108291;3;1;0;4;MDU
108292;15;0;0;15;MDU
108293;12;0;0;12;MDU
108294;17;0;0;17;MDU
108296;5;1;0;6;MDU
108297;0;1;0;1;SDU
108298;0;2;0;2;MDU
108299;103;0;0;103;MDU
108300;8;0;0;8;MDU
108301;2;0;0;2;MDU
108303;0;1;0;1;SDU
108305;0;1;0;1;SDU
108306;0;1;0;1;SDU
108308;0;1;0;1;SDU
108331;1;1;0;2;MDU
108332;4;1;0;5;MDU
108782;4;0;0;4;MDU
108783;4;0;0;4;MDU
108785;5;0;0;5;MDU
108786;8;0;0;8;MDU
108787;3;2;0;5;MDU
108788;2;1;1;4;MDU
108790;0;2;0;2;MDU
108791;6;0;0;6;MDU
108792;4;0;0;4;MDU
108793;3;2;0;5;MDU
108794;0;1;0;1;SDU
108795;0;1;0;1;SDU
108796;7;1;0;8;MDU
108797;0;3;1;4;MDU
108798;4;1;0;5;MDU
108799;3;1;1;5;MDU
108800;3;1;1;5;MDU
108801;0;1;0;1;SDU
108928;2;0;0;2;MDU
108929;13;5;0;18;MDU
108930;1;1;0;2;MDU
108931;0;1;0;1;SDU
108936;2;1;1;4;MDU
108937;0;1;0;1;SDU
108939;0;1;0;1;SDU
108940;1;0;1;2;SDU
108942;0;1;0;1;SDU
108947;17;1;0;18;MDU
108948;0;1;1;2;SDU
108951;4;1;0;5;MDU
108952;0;1;0;1;SDU
108955;4;0;0;4;MDU
108956;2;1;1;4;MDU
108957;2;0;0;2;MDU
108958;15;2;0;17;MDU
109069;0;1;0;1;SDU
109072;0;4;0;4;MDU
109078;5;1;1;7;MDU
109084;2;1;1;4;MDU
109132;0;2;0;2;MDU
109133;0;2;0;2;MDU
109135;5;1;0;6;MDU
109136;1;0;0;1;SDU
109137;3;0;1;4;MDU
109139;6;0;0;6;MDU
109140;0;2;1;3;MDU
109142;0;1;0;1;SDU
109143;3;1;1;5;MDU
109146;2;1;1;4;MDU
109147;0;2;0;2;MDU
182977;0;1;0;1;SDU
185911;48;10;0;58;MDU
186503;3;1;0;4;MDU
186506;8;4;0;12;MDU
186508;4;1;0;5;MDU
186509;3;0;1;4;MDU
186510;3;0;1;4;MDU
186515;0;4;1;5;MDU
186516;8;9;0;17;MDU
186517;0;1;0;1;SDU
186518;0;6;1;7;MDU
186519;3;2;0;5;MDU
186520;0;1;0;1;SDU
186521;0;2;0;2;MDU
972217;0;0;5;5;SDU
1015486;0;1;0;1;SDU
1088758;227;2;0;229;MDU
1088919;11;0;0;11;MDU
1088922;1;0;0;1;SDU
1088925;0;2;0;2;MDU
1089007;0;2;0;2;MDU
1090148;20;5;0;25;MDU
1128020;5;2;0;7;MDU
1128021;5;0;1;6;MDU
1128022;4;0;1;5;MDU
1128023;5;1;1;7;MDU
1128025;7;2;1;10;MDU
1128026;0;2;0;2;MDU
1128028;13;0;0;13;MDU
1128029;12;1;0;13;MDU
1128032;0;2;0;2;MDU
1128033;3;1;0;4;MDU
1128034;3;1;0;4;MDU
1128035;5;1;0;6;MDU
1128036;0;3;0;3;MDU
1128037;0;2;0;2;MDU
1164771;0;1;0;1;SDU
1195063;39;0;3;42;MDU
1195065;47;0;0;47;MDU
1206770;24;4;1;29;MDU
1215943;0;1;0;1;SDU
1265934;5;0;0;5;MDU
1266447;3;1;1;5;MDU
1266714;6;0;0;6;MDU
1287193;0;5;0;5;MDU
1288092;15;1;0;16;MDU
1292390;0;1;0;1;SDU
1294704;8;0;0;8;MDU
1295616;0;1;0;1;SDU
1299606;26;3;0;29;MDU
1365795;14;0;0;14;MDU
1366835;0;2;0;2;MDU
1454935;7;0;0;7;MDU
1506186;0;6;0;6;MDU
1513863;10;1;1;12;MDU
1734625;0;6;0;6;MDU
1734627;4;2;0;6;MDU
1734631;1;1;0;2;MDU
1734632;6;0;1;7;MDU
1734633;4;0;1;5;MDU
1734634;4;1;1;6;MDU
1734635;8;0;1;9;MDU
1734636;0;1;0;1;SDU
1734637;0;1;0;1;SDU
1734638;1;1;0;2;MDU
1735088;20;0;0;20;MDU
1735094;0;5;0;5;MDU
1735095;0;4;0;4;MDU
1735096;0;1;0;1;SDU
1735097;3;1;1;5;MDU
1735098;6;2;1;9;MDU
1735099;4;1;1;6;MDU
1735100;15;2;0;17;MDU
1735101;16;0;1;17;MDU
1735103;0;1;0;1;SDU
1735104;8;1;1;10;MDU
1735105;2;1;0;3;MDU
1735143;0;1;1;2;SDU
1735144;0;1;0;1;SDU
1746379;0;1;0;1;SDU
1755770;3;0;1;4;MDU
1755771;9;0;1;10;MDU
1755772;0;1;0;1;SDU
1755774;0;1;0;1;SDU
1755779;11;1;0;12;MDU
1775168;0;1;0;1;SDU
1775171;5;0;0;5;MDU
1775176;3;1;0;4;MDU
1775185;0;1;0;1;SDU
1775191;0;1;0;1;SDU
1775195;0;3;0;3;MDU
1775199;7;6;0;13;MDU
1775203;3;0;1;4;MDU
1775206;4;0;0;4;MDU
1775213;0;1;0;1;SDU
1775218;1;1;2;4;MDU
1775235;27;2;0;29;MDU
1775251;1;0;0;1;SDU
1775252;4;0;1;5;MDU
1775258;1;0;0;1;SDU
1781985;0;1;1;2;SDU
1782029;0;1;0;1;SDU
1782040;4;0;0;4;MDU
1782047;2;0;0;2;MDU
1782050;3;1;1;5;MDU
1786771;3;1;0;4;MDU
1786795;5;1;1;7;MDU
1786838;111;0;0;111;MDU
1786894;11;1;0;12;MDU
1786953;13;0;0;13;MDU
1786975;33;0;0;33;MDU
1866317;0;1;0;1;SDU
1892372;4;0;0;4;MDU
1892380;7;0;0;7;MDU
1892421;4;0;0;4;MDU
1892429;12;0;0;12;MDU
1892443;1;0;0;1;SDU
1892503;3;1;0;4;MDU
1905254;2;0;0;2;MDU
1905268;2;1;0;3;MDU
1905273;1;1;0;2;MDU
1905398;14;0;0;14;MDU
1905577;0;1;0;1;SDU
1905601;6;2;0;8;MDU
1905643;2;1;0;3;MDU
1905662;2;0;0;2;MDU
1948956;0;2;0;2;MDU
1948967;0;4;0;4;MDU
1949013;0;1;0;1;SDU
1949119;5;1;1;7;MDU
1949129;0;3;1;4;MDU
1949160;7;1;0;8;MDU
1949181;4;0;1;5;MDU
1949212;0;1;0;1;SDU
1950413;0;2;0;2;MDU
1960564;1;0;0;1;SDU
1960565;1;0;1;2;SDU
1960566;4;0;1;5;MDU
1960567;10;0;0;10;MDU
1960568;2;1;0;3;MDU
1960569;6;0;1;7;MDU
1960570;2;0;0;2;MDU
1960571;7;0;1;8;MDU
1960572;0;1;0;1;SDU
1960573;3;0;0;3;MDU
1960577;0;1;0;1;SDU
1960580;3;2;1;6;MDU
1960581;6;1;0;7;MDU
1960582;6;1;0;7;MDU
1960583;2;1;0;3;MDU
1960584;8;1;0;9;MDU
1960586;0;2;0;2;MDU
1960587;10;0;0;10;MDU
1960880;0;1;0;1;SDU
1960881;1;0;1;2;SDU
1960882;2;0;1;3;MDU
1960885;4;0;0;4;MDU
1960886;4;0;1;5;MDU
1960887;4;0;0;4;MDU
1960888;3;1;0;4;MDU
1960890;4;1;0;5;MDU
1960891;3;1;0;4;MDU
1960892;5;1;0;6;MDU
1960893;5;1;0;6;MDU
1960897;10;0;0;10;MDU
1970926;11;4;0;15;MDU
1970933;0;1;0;1;SDU
1970943;11;0;0;11;MDU
1970946;2;1;0;3;MDU
1970954;3;1;0;4;MDU
1970973;5;0;0;5;MDU
1970980;2;1;1;4;MDU
1970984;0;3;0;3;MDU
1970988;0;1;0;1;SDU
1984031;0;2;0;2;MDU
1984033;0;1;0;1;SDU
1986445;0;1;0;1;SDU
1986450;0;1;0;1;SDU
1986469;0;3;0;3;MDU
1986483;4;1;0;5;MDU
1986487;0;3;1;4;MDU
1986500;4;1;0;5;MDU
1986516;3;1;0;4;MDU
1986523;2;0;0;2;MDU
1992472;2;1;1;4;MDU
1992477;4;0;1;5;MDU
1992481;3;1;1;5;MDU
1992482;2;0;0;2;MDU
1992485;2;0;1;3;MDU
1992486;0;1;0;1;SDU
1992488;2;1;1;4;MDU
1992494;6;0;0;6;MDU
1992495;1;0;0;1;SDU
1992496;8;0;0;8;MDU
1992508;3;1;1;5;MDU
1992511;4;1;1;6;MDU
1992517;5;1;0;6;MDU
1992519;0;1;1;2;SDU
1992528;3;1;1;5;MDU
1992540;4;0;1;5;MDU
1992550;0;1;0;1;SDU
1992553;1;2;0;3;MDU
1992555;1;1;0;2;MDU
1992559;0;1;0;1;SDU
1992561;4;1;0;5;MDU
1992564;15;1;0;16;MDU
1992566;1;1;1;3;MDU
1992570;4;1;1;6;MDU
1992574;3;0;0;3;MDU
2008888;9;0;0;9;MDU
2008915;1;0;1;2;SDU
2008923;11;3;0;14;MDU
2008939;5;0;0;5;MDU
2008982;0;1;0;1;SDU
2008988;0;1;0;1;SDU
2009000;9;1;0;10;MDU
2009021;5;0;1;6;MDU
2009033;0;4;1;5;MDU
2015971;0;1;0;1;SDU
2015972;0;1;0;1;SDU
2024620;2;0;0;2;MDU
2024624;4;0;0;4;MDU
2024627;4;0;0;4;MDU
2024631;4;0;0;4;MDU
2024634;4;0;0;4;MDU
2024639;0;1;0;1;SDU
2024656;7;0;0;7;MDU
2024662;0;2;0;2;MDU
2024695;4;1;0;5;MDU
2024698;5;1;0;6;MDU
2024710;2;1;0;3;MDU
2024713;2;1;0;3;MDU
2024715;7;1;0;8;MDU
2024719;12;0;0;12;MDU
2024723;0;1;0;1;SDU
2024728;2;1;0;3;MDU
2024731;2;1;0;3;MDU
2024753;1;1;0;2;MDU
2024759;11;0;0;11;MDU
2024763;0;1;0;1;SDU
2024771;8;0;0;8;MDU
2024772;5;0;0;5;MDU
2024775;5;2;0;7;MDU
2024779;0;1;0;1;SDU
2024783;3;1;0;4;MDU
2024788;4;0;0;4;MDU
2024791;4;0;0;4;MDU
2024799;0;1;0;1;SDU
2024805;3;1;0;4;MDU
2024854;5;0;0;5;MDU
2024869;3;0;1;4;MDU
2024873;4;1;0;5;MDU
2024875;4;1;1;6;MDU
2024882;3;1;1;5;MDU
2024884;4;2;1;7;MDU
2024895;7;1;0;8;MDU
2024906;0;1;0;1;SDU
2024910;1;1;0;2;MDU
2024913;13;0;0;13;MDU
2024934;5;1;1;7;MDU
2024938;5;1;0;6;MDU
2024953;4;0;1;5;MDU
2024962;0;2;0;2;MDU
2028886;0;1;0;1;SDU
2047563;4;1;1;6;MDU
2047587;0;1;0;1;SDU
2047589;0;6;0;6;MDU
2047591;3;2;0;5;MDU
2047593;6;2;1;9;MDU
2047595;8;1;1;10;MDU
2047596;5;0;1;6;MDU
2047597;5;0;1;6;MDU
2047598;13;1;0;14;MDU
2047602;0;1;0;1;SDU
2047604;0;1;0;1;SDU
2051445;1;1;0;2;MDU
2051446;5;1;0;6;MDU
2051449;3;1;1;5;MDU
2051451;1;1;0;2;MDU
2051452;5;0;1;6;MDU
2051455;1;1;0;2;MDU
2053439;1;0;0;1;SDU
2053440;3;1;0;4;MDU
2056114;0;2;0;2;MDU
2059541;6;2;0;8;MDU
2059542;5;0;0;5;MDU
2059544;0;1;0;1;SDU
2059545;0;1;0;1;SDU
2059548;1;1;2;4;MDU
2059549;5;1;0;6;MDU
2059550;2;1;0;3;MDU
2059551;4;1;0;5;MDU
2059552;1;1;0;2;MDU
2059553;0;1;0;1;SDU
2059554;10;0;0;10;MDU
2059555;0;1;0;1;SDU
2059556;8;0;0;8;MDU
2059557;4;1;0;5;MDU
2066332;4;0;1;5;MDU
2066334;0;1;0;1;SDU
2067063;0;5;1;6;MDU
2069012;10;0;0;10;MDU
2069014;0;3;0;3;MDU
2069015;12;0;0;12;MDU
2069017;9;0;0;9;MDU
2069018;0;2;0;2;MDU
2069019;14;0;0;14;MDU
2069021;0;1;0;1;SDU
2069022;8;0;0;8;MDU
2069024;13;0;0;13;MDU
2069025;0;1;0;1;SDU
3918458;4;0;2;6;MDU
3928764;0;2;0;2;MDU
3954604;0;2;0;2;MDU
3962176;12;0;0;12;MDU
3962177;10;5;0;15;MDU
3989962;4;2;0;6;MDU
3998019;0;1;1;2;SDU
4016605;27;1;0;28;MDU
4021011;0;1;0;1;SDU
4031647;0;1;0;1;SDU
4042596;0;2;0;2;MDU
4048591;28;0;0;28;MDU
4048873;1;0;1;2;SDU
4059303;0;1;0;1;SDU
4066155;0;2;0;2;MDU
4070580;2;0;0;2;MDU
4081990;8;0;0;8;MDU
4083535;0;2;0;2;MDU
4092751;2;1;1;4;MDU
4101358;0;2;1;3;MDU
4126592;21;0;0;21;MDU
4128342;0;1;0;1;SDU
4128343;0;9;0;9;MDU
4128344;0;9;0;9;MDU
4145817;7;0;0;7;MDU
4153712;4;0;1;5;MDU
4153735;0;1;0;1;SDU
4155271;4;0;0;4;MDU
4244346;0;2;1;3;MDU
4274709;26;2;0;28;MDU
4505438;0;1;0;1;SDU
4505440;7;0;0;7;MDU
4505441;0;1;0;1;SDU
4505442;7;0;0;7;MDU
4505443;0;1;0;1;SDU
4505458;0;1;0;1;SDU
4505462;1;0;0;1;SDU
4505465;4;0;0;4;MDU
4505471;2;0;0;2;MDU
4505491;4;0;0;4;MDU
4505621;5;0;0;5;MDU
4505623;18;0;0;18;MDU
4505626;9;0;0;9;MDU
4505630;0;2;0;2;MDU
4506128;1;1;0;2;MDU
4506338;0;1;0;1;SDU
4506340;0;2;0;2;MDU
4506351;0;1;0;1;SDU
4506352;0;1;1;2;SDU
4506358;6;0;0;6;MDU
4506359;2;0;0;2;MDU
4506376;0;1;0;1;SDU
4506378;3;1;0;4;MDU
4506381;0;1;0;1;SDU
4506382;8;0;0;8;MDU
4506388;3;1;0;4;MDU
4506389;0;1;0;1;SDU
4506391;0;1;0;1;SDU
4506392;3;1;0;4;MDU
4506393;6;0;0;6;MDU
4507060;0;1;0;1;SDU
4509558;0;1;0;1;SDU
4510542;3;1;1;5;MDU
4510550;0;1;0;1;SDU
4510554;0;1;0;1;SDU
4510612;24;0;1;25;MDU
4510620;0;1;0;1;SDU
4510623;0;1;0;1;SDU
4510628;0;1;0;1;SDU
4510637;4;0;0;4;MDU
4510642;6;1;0;7;MDU
4510648;3;0;0;3;MDU
4510651;1;0;0;1;SDU
4511892;4;1;0;5;MDU
4511908;1;0;0;1;SDU
4511909;1;0;0;1;SDU
4511917;0;0;1;1;SDU
4511920;0;1;0;1;SDU
4511924;0;1;0;1;SDU
4511927;0;1;0;1;SDU
4511975;5;0;0;5;MDU
4511988;0;1;0;1;SDU
4511990;0;1;0;1;SDU
4511991;0;0;1;1;SDU
4511992;2;0;1;3;MDU
4511993;3;0;2;5;MDU
4513293;0;1;0;1;SDU
4513307;0;3;1;4;MDU
4513324;0;1;0;1;SDU
4513329;3;0;1;4;MDU
5320926;1;0;0;1;SDU
5394016;0;0;13;13;SDU
5448225;0;1;0;1;SDU
5492426;0;2;0;2;MDU
5507307;0;1;0;1;SDU
5507308;1;0;0;1;SDU
5507309;0;1;0;1;SDU
5507310;0;1;0;1;SDU
5507311;0;1;0;1;SDU
5507312;8;0;0;8;MDU
5508518;3;8;0;11;MDU
5563826;0;1;0;1;SDU
5569316;7;0;0;7;MDU
5575022;8;0;0;8;MDU
5575585;1;2;0;3;MDU
5575786;0;1;0;1;SDU
5575903;0;0;1;1;SDU
5576029;4;0;0;4;MDU
5576453;2;4;1;7;MDU
5576507;10;0;0;10;MDU
5751357;0;1;0;1;SDU
5802357;0;1;0;1;SDU
5802358;0;1;0;1;SDU
5804911;0;1;0;1;SDU
5804916;66;2;3;71;MDU
5835595;0;1;0;1;SDU
5891727;64;1;0;65;MDU
5906909;0;2;0;2;MDU
5911749;3;0;0;3;MDU
5944504;108;1;0;109;MDU
5944507;63;1;0;64;MDU
5960425;2;0;0;2;MDU
5963666;0;3;0;3;MDU
5976489;0;1;0;1;SDU
5978286;0;1;0;1;SDU
6000240;7;0;0;7;MDU
6005416;21;0;0;21;MDU
6027282;0;1;0;1;SDU
6027745;0;1;0;1;SDU
6058636;0;1;0;1;SDU
6198471;0;1;0;1;SDU
6242346;0;1;0;1;SDU
6369818;4;0;0;4;MDU
6369819;4;0;0;4;MDU
6375622;0;1;0;1;SDU
6395025;0;1;0;1;SDU
6427222;0;1;0;1;SDU
6440424;0;1;0;1;SDU
6452833;2;0;0;2;MDU
6452834;2;0;0;2;MDU
6519266;76;0;0;76;MDU
6519267;4;0;0;4;MDU
6519268;4;0;0;4;MDU
6525841;0;1;0;1;SDU
6525842;0;1;0;1;SDU
6525843;0;1;0;1;SDU